---------------
-------P-------
-------o-------
------ooo------
------oCo------
------ooo------
----oooCooo----
---X---o---X---
---------------
---------------
---------------
