---------------
----X-----X----
----ooo-ooo----
----o--o--o----
--o-o-oCo-o-o--
-PoCoooCoooooo-
----o--C--o----
----o-ooo-o----
----Xo---oX----
---------------
---------------
