------ooo------
------oCo------
--oooo-o-oooo--
--oCo--o--oCo--
---o-ooooo-o---
---o--o-o--o---
--oooo-P-oooo--
--oXo--o--oXo--
---o-ooooo-o---
------oXo------
-------o-------
