---------------
---------------
---oXo-oooCo---
---oCooo-oXo---
---oXo-oPoCo---
---oCooo-oXo---
---oXo-oooCo---
---o-o-o-o-o---
---------------
---------------
---------------
